[6,10]
(0,0)
(9,5) | (8,2)
(2,1,3,2)
(4,4,2,1)
(7,3,1,3)
(0,2,1,3)
(4,0,2,1)