[8,9]
(2,1)
(8,7) | (5,0)
(1,3,2,2)
(4,5,3,1)
(6,2,1,2)
(3,6,1,2)
(7,4,2,1)