[10,10]
(3,2)
(9,9) | (8,0)
(1,1,2,2)
(4,4,3,2)
(0,7,1,3)
(6,6,2,1)
(8,8,1,2)
