[11,9]
(6,1)
(8,10) | (0,0)
(4,2,2,2)
(1,8,3,1)
(7,4,1,2)
(3,5,2,1)
(5,7,2,2)
