[8, 12]
(0, 0)
(11,7) | (8,3)
(2,1,2,3)
(5,4,1,2)
(9,6,2,1)
(1,5,3,1)
(7,2,1,2)
